[GATE_CONNECTIONS]
2	4	0	0	0	0	0	0
3	4	0	0	0	0	0	0
4	4	0	1	0	0	0	1
4	3	0	0	0	0	0	0
5	2	0	0	0	0	0	0
6	2	0	1	0	0	0	0
7	2	0	0	0	0	0	0
9	2	0	0	0	0	0	0
11	2	0	0	0	0	0	0
12	2	0	1	0	0	0	0
12	3	0	0	0	0	0	0
11	4	0	0	0	0	0	0
9	4	0	0	0	0	0	0
8	3	0	0	0	0	0	0
8	4	0	1	0	0	0	0
8	5	0	0	0	0	0	0
7	6	0	0	0	0	0	0
5	6	0	0	0	0	0	0
4	6	0	1	0	0	0	0
4	7	0	0	0	0	0	0
4	8	0	1	0	0	0	0
4	9	0	0	0	0	0	0
5	10	0	0	0	0	0	0
6	10	0	1	0	0	0	0
7	10	0	0	0	0	0	0
8	9	0	0	0	0	0	0
8	8	0	1	0	0	0	0
7	8	0	0	0	0	0	0
9	8	0	0	0	0	0	0
10	8	0	1	0	0	0	0
11	8	0	0	0	0	0	0
[GATES]
4	2	1	100
8	2	0	100
10	2	0	100
12	4	0	100
10	4	0	100
8	6	0	100
6	6	0	100
4	5	0	100
4	10	0	100
8	10	0	100
6	8	0	100
12	8	0	100
[PLAYER]
4	2
